type octile
height 84
width 170
map
TTTTTTTTTTTTTTTTTTTTTTTTTTTTTTTTTTTTTTTTTTTTTTTTTTTTTTTTTTTTTTTTTTTTTTTTTTTTTTTTTTTTTTTTTTTTTTTTTTTTTTTTTTTTTTTTTTTTTTTTTTTTTTTTTTTTTTTTTTTTTTTTTTTTTTTTTTTTTTTTTTTTTTTTTT
T.........................TT..................................................................................................................TT.........................T
T.........................TT..................................................................................................................TT.........................T
T.........................TTTTTTTTTT..TTTTTTTTTT..TTTTTTTTTT..TTTTTTTTTT..TTTTTTTTTT..TTTTTTTTTT..TTTTTTTTTT..TTTTTTTTTT..TTTTTTTTTT..TTTTTTTTTT.........................T
T.........................TTTTTTTTTT..TTTTTTTTTT..TTTTTTTTTT..TTTTTTTTTT..TTTTTTTTTT..TTTTTTTTTT..TTTTTTTTTT..TTTTTTTTTT..TTTTTTTTTT..TTTTTTTTTT.........................T
T.........................TT..................................................................................................................TT.........................T
T.........................TT..................................................................................................................TT.........................T
T.........................TTTTTTTTTT..TTTTTTTTTT..TTTTTTTTTT..TTTTTTTTTT..TTTTTTTTTT..TTTTTTTTTT..TTTTTTTTTT..TTTTTTTTTT..TTTTTTTTTT..TTTTTTTTTT.........................T
T.........................TTTTTTTTTT..TTTTTTTTTT..TTTTTTTTTT..TTTTTTTTTT..TTTTTTTTTT..TTTTTTTTTT..TTTTTTTTTT..TTTTTTTTTT..TTTTTTTTTT..TTTTTTTTTT.........................T
T.........................TT..................................................................................................................TT.........................T
T.........................TT..................................................................................................................TT.........................T
T.........................TTTTTTTTTT..TTTTTTTTTT..TTTTTTTTTT..TTTTTTTTTT..TTTTTTTTTT..TTTTTTTTTT..TTTTTTTTTT..TTTTTTTTTT..TTTTTTTTTT..TTTTTTTTTT.........................T
T.........................TTTTTTTTTT..TTTTTTTTTT..TTTTTTTTTT..TTTTTTTTTT..TTTTTTTTTT..TTTTTTTTTT..TTTTTTTTTT..TTTTTTTTTT..TTTTTTTTTT..TTTTTTTTTT.........................T
T.........................TT..................................................................................................................TT.........................T
T.........................TT..................................................................................................................TT.........................T
T.........................TTTTTTTTTT..TTTTTTTTTT..TTTTTTTTTT..TTTTTTTTTT..TTTTTTTTTT..TTTTTTTTTT..TTTTTTTTTT..TTTTTTTTTT..TTTTTTTTTT..TTTTTTTTTT.........................T
T.........................TTTTTTTTTT..TTTTTTTTTT..TTTTTTTTTT..TTTTTTTTTT..TTTTTTTTTT..TTTTTTTTTT..TTTTTTTTTT..TTTTTTTTTT..TTTTTTTTTT..TTTTTTTTTT.........................T
T.........................TT..................................................................................................................TT.........................T
T.........................TT..................................................................................................................TT.........................T
T.........................TTTTTTTTTT..TTTTTTTTTT..TTTTTTTTTT..TTTTTTTTTT..TTTTTTTTTT..TTTTTTTTTT..TTTTTTTTTT..TTTTTTTTTT..TTTTTTTTTT..TTTTTTTTTT.........................T
T.........................TTTTTTTTTT..TTTTTTTTTT..TTTTTTTTTT..TTTTTTTTTT..TTTTTTTTTT..TTTTTTTTTT..TTTTTTTTTT..TTTTTTTTTT..TTTTTTTTTT..TTTTTTTTTT.........................T
T.........................TT..................................................................................................................TT.........................T
T.........................TT..................................................................................................................TT.........................T
T.........................TTTTTTTTTT..TTTTTTTTTT..TTTTTTTTTT..TTTTTTTTTT..TTTTTTTTTT..TTTTTTTTTT..TTTTTTTTTT..TTTTTTTTTT..TTTTTTTTTT..TTTTTTTTTT.........................T
T.........................TTTTTTTTTT..TTTTTTTTTT..TTTTTTTTTT..TTTTTTTTTT..TTTTTTTTTT..TTTTTTTTTT..TTTTTTTTTT..TTTTTTTTTT..TTTTTTTTTT..TTTTTTTTTT.........................T
T.........................TT..................................................................................................................TT.........................T
T.........................TT..................................................................................................................TT.........................T
T.........................TTTTTTTTTT..TTTTTTTTTT..TTTTTTTTTT..TTTTTTTTTT..TTTTTTTTTT..TTTTTTTTTT..TTTTTTTTTT..TTTTTTTTTT..TTTTTTTTTT..TTTTTTTTTT.........................T
T.........................TTTTTTTTTT..TTTTTTTTTT..TTTTTTTTTT..TTTTTTTTTT..TTTTTTTTTT..TTTTTTTTTT..TTTTTTTTTT..TTTTTTTTTT..TTTTTTTTTT..TTTTTTTTTT.........................T
T.........................TT..................................................................................................................TT.........................T
T.........................TT..................................................................................................................TT.........................T
T.........................TTTTTTTTTT..TTTTTTTTTT..TTTTTTTTTT..TTTTTTTTTT..TTTTTTTTTT..TTTTTTTTTT..TTTTTTTTTT..TTTTTTTTTT..TTTTTTTTTT..TTTTTTTTTT.........................T
T.........................TTTTTTTTTT..TTTTTTTTTT..TTTTTTTTTT..TTTTTTTTTT..TTTTTTTTTT..TTTTTTTTTT..TTTTTTTTTT..TTTTTTTTTT..TTTTTTTTTT..TTTTTTTTTT.........................T
T.........................TT..................................................................................................................TT.........................T
T.........................TT..................................................................................................................TT.........................T
T.........................TTTTTTTTTT..TTTTTTTTTT..TTTTTTTTTT..TTTTTTTTTT..TTTTTTTTTT..TTTTTTTTTT..TTTTTTTTTT..TTTTTTTTTT..TTTTTTTTTT..TTTTTTTTTT.........................T
T.........................TTTTTTTTTT..TTTTTTTTTT..TTTTTTTTTT..TTTTTTTTTT..TTTTTTTTTT..TTTTTTTTTT..TTTTTTTTTT..TTTTTTTTTT..TTTTTTTTTT..TTTTTTTTTT.........................T
T........................................................................................................................................................................T
T........................................................................................................................................................................T
T.........................TTTTTTTTTT..TTTTTTTTTT..TTTTTTTTTT..TTTTTTTTTT..TTTTTTTTTT..TTTTTTTTTT..TTTTTTTTTT..TTTTTTTTTT..TTTTTTTTTT..TTTTTTTTTT.........................T
T.........................TTTTTTTTTT..TTTTTTTTTT..TTTTTTTTTT..TTTTTTTTTT..TTTTTTTTTT..TTTTTTTTTT..TTTTTTTTTT..TTTTTTTTTT..TTTTTTTTTT..TTTTTTTTTT.........................T
T.........................TT..................................................................................................................TT.........................T
T.........................TT..................................................................................................................TT.........................T
T.........................TTTTTTTTTT..TTTTTTTTTT..TTTTTTTTTT..TTTTTTTTTT..TTTTTTTTTT..TTTTTTTTTT..TTTTTTTTTT..TTTTTTTTTT..TTTTTTTTTT..TTTTTTTTTT.........................T
T.........................TTTTTTTTTT..TTTTTTTTTT..TTTTTTTTTT..TTTTTTTTTT..TTTTTTTTTT..TTTTTTTTTT..TTTTTTTTTT..TTTTTTTTTT..TTTTTTTTTT..TTTTTTTTTT.........................T
T.........................TT..................................................................................................................TT.........................T
T.........................TT..................................................................................................................TT.........................T
T.........................TTTTTTTTTT..TTTTTTTTTT..TTTTTTTTTT..TTTTTTTTTT..TTTTTTTTTT..TTTTTTTTTT..TTTTTTTTTT..TTTTTTTTTT..TTTTTTTTTT..TTTTTTTTTT.........................T
T.........................TTTTTTTTTT..TTTTTTTTTT..TTTTTTTTTT..TTTTTTTTTT..TTTTTTTTTT..TTTTTTTTTT..TTTTTTTTTT..TTTTTTTTTT..TTTTTTTTTT..TTTTTTTTTT.........................T
T.........................TT..................................................................................................................TT.........................T
T.........................TT..................................................................................................................TT.........................T
T.........................TTTTTTTTTT..TTTTTTTTTT..TTTTTTTTTT..TTTTTTTTTT..TTTTTTTTTT..TTTTTTTTTT..TTTTTTTTTT..TTTTTTTTTT..TTTTTTTTTT..TTTTTTTTTT.........................T
T.........................TTTTTTTTTT..TTTTTTTTTT..TTTTTTTTTT..TTTTTTTTTT..TTTTTTTTTT..TTTTTTTTTT..TTTTTTTTTT..TTTTTTTTTT..TTTTTTTTTT..TTTTTTTTTT.........................T
T.........................TT..................................................................................................................TT.........................T
T.........................TT..................................................................................................................TT.........................T
T.........................TTTTTTTTTT..TTTTTTTTTT..TTTTTTTTTT..TTTTTTTTTT..TTTTTTTTTT..TTTTTTTTTT..TTTTTTTTTT..TTTTTTTTTT..TTTTTTTTTT..TTTTTTTTTT.........................T
T.........................TTTTTTTTTT..TTTTTTTTTT..TTTTTTTTTT..TTTTTTTTTT..TTTTTTTTTT..TTTTTTTTTT..TTTTTTTTTT..TTTTTTTTTT..TTTTTTTTTT..TTTTTTTTTT.........................T
T.........................TT..................................................................................................................TT.........................T
T.........................TT..................................................................................................................TT.........................T
T.........................TTTTTTTTTT..TTTTTTTTTT..TTTTTTTTTT..TTTTTTTTTT..TTTTTTTTTT..TTTTTTTTTT..TTTTTTTTTT..TTTTTTTTTT..TTTTTTTTTT..TTTTTTTTTT.........................T
T.........................TTTTTTTTTT..TTTTTTTTTT..TTTTTTTTTT..TTTTTTTTTT..TTTTTTTTTT..TTTTTTTTTT..TTTTTTTTTT..TTTTTTTTTT..TTTTTTTTTT..TTTTTTTTTT.........................T
T.........................TT..................................................................................................................TT.........................T
T.........................TT..................................................................................................................TT.........................T
T.........................TTTTTTTTTT..TTTTTTTTTT..TTTTTTTTTT..TTTTTTTTTT..TTTTTTTTTT..TTTTTTTTTT..TTTTTTTTTT..TTTTTTTTTT..TTTTTTTTTT..TTTTTTTTTT.........................T
T.........................TTTTTTTTTT..TTTTTTTTTT..TTTTTTTTTT..TTTTTTTTTT..TTTTTTTTTT..TTTTTTTTTT..TTTTTTTTTT..TTTTTTTTTT..TTTTTTTTTT..TTTTTTTTTT.........................T
T.........................TT..................................................................................................................TT.........................T
T.........................TT..................................................................................................................TT.........................T
T.........................TTTTTTTTTT..TTTTTTTTTT..TTTTTTTTTT..TTTTTTTTTT..TTTTTTTTTT..TTTTTTTTTT..TTTTTTTTTT..TTTTTTTTTT..TTTTTTTTTT..TTTTTTTTTT.........................T
T.........................TTTTTTTTTT..TTTTTTTTTT..TTTTTTTTTT..TTTTTTTTTT..TTTTTTTTTT..TTTTTTTTTT..TTTTTTTTTT..TTTTTTTTTT..TTTTTTTTTT..TTTTTTTTTT.........................T
T.........................TT..................................................................................................................TT.........................T
T.........................TT..................................................................................................................TT.........................T
T.........................TTTTTTTTTT..TTTTTTTTTT..TTTTTTTTTT..TTTTTTTTTT..TTTTTTTTTT..TTTTTTTTTT..TTTTTTTTTT..TTTTTTTTTT..TTTTTTTTTT..TTTTTTTTTT.........................T
T.........................TTTTTTTTTT..TTTTTTTTTT..TTTTTTTTTT..TTTTTTTTTT..TTTTTTTTTT..TTTTTTTTTT..TTTTTTTTTT..TTTTTTTTTT..TTTTTTTTTT..TTTTTTTTTT.........................T
T.........................TT..................................................................................................................TT.........................T
T.........................TT..................................................................................................................TT.........................T
T.........................TTTTTTTTTT..TTTTTTTTTT..TTTTTTTTTT..TTTTTTTTTT..TTTTTTTTTT..TTTTTTTTTT..TTTTTTTTTT..TTTTTTTTTT..TTTTTTTTTT..TTTTTTTTTT.........................T
T.........................TTTTTTTTTT..TTTTTTTTTT..TTTTTTTTTT..TTTTTTTTTT..TTTTTTTTTT..TTTTTTTTTT..TTTTTTTTTT..TTTTTTTTTT..TTTTTTTTTT..TTTTTTTTTT.........................T
T.........................TT..................................................................................................................TT.........................T
T.........................TT..................................................................................................................TT.........................T
T.........................TTTTTTTTTT..TTTTTTTTTT..TTTTTTTTTT..TTTTTTTTTT..TTTTTTTTTT..TTTTTTTTTT..TTTTTTTTTT..TTTTTTTTTT..TTTTTTTTTT..TTTTTTTTTT.........................T
T.........................TTTTTTTTTT..TTTTTTTTTT..TTTTTTTTTT..TTTTTTTTTT..TTTTTTTTTT..TTTTTTTTTT..TTTTTTTTTT..TTTTTTTTTT..TTTTTTTTTT..TTTTTTTTTT.........................T
T.........................TT..................................................................................................................TT.........................T
T.........................TT..................................................................................................................TT.........................T
TTTTTTTTTTTTTTTTTTTTTTTTTTTTTTTTTTTTTTTTTTTTTTTTTTTTTTTTTTTTTTTTTTTTTTTTTTTTTTTTTTTTTTTTTTTTTTTTTTTTTTTTTTTTTTTTTTTTTTTTTTTTTTTTTTTTTTTTTTTTTTTTTTTTTTTTTTTTTTTTTTTTTTTTTT
